*&----------------------------------------------------------------------*
*&             T A B L E S    D E C L A R A R A T I O N			*
*&----------------------------------------------------------------------*


*&----------------------------------------------------------------------*
*&             G L O B A L  T Y P E S    D E C L A R A R A T I O N	*
*&----------------------------------------------------------------------*



*&----------------------------------------------------------------------*
*&             G L O B A L     I N T E R N A L T A B L E S && WA        *
*&----------------------------------------------------------------------*




*&----------------------------------------------------------------------*
*&             C O N S T A N T S					*
*&----------------------------------------------------------------------*



*&----------------------------------------------------------------------*
*&             S E L E C T I O N  S C R E E N				*
*&----------------------------------------------------------------------*




*&----------------------------------------------------------------------*
*&             A T  S E L E C T I  O N  S C R E E  N ON                 *
*&----------------------------------------------------------------------*



*&----------------------------------------------------------------------*
*&             S T A R  T - O F - S E L E  C T I O N                    *
*&----------------------------------------------------------------------*



*&----------------------------------------------------------------------*
*&             E N D - O F -  S E L E C T  I O N                        *
*&----------------------------------------------------------------------*